Авиафобия - боязнь полетов
Нозокомефобия — боязнь больниц
Ранидофобия - боязнь лягушек
Отсутствует
Гипнофобия - боязнь заснуть
Графофобия — боязнь писать или брать в руки письменные принадлежности
Робофобия — страх по отношению к любой робототехнике
Трипанофобия — боязнь игл и уколов
Отсутствует
Гнозиофобия (эпистемофобия) — боязнь знания/познания
Танатофобия - боязнь смерти
Эротофобия — боязнь секса или вопросов о сексе
Бромгидрофобия — боязнь, что окружающие могут заметить неприятный запах тела или потливость больного данной фобий
Агорафобия - боязнь открытых мест и пространств
Гиерофобия — боязнь предметов религиозного культа
Венерофобия - боязнь заболеть венерической болезнью
Лифтофобия — боязнь лифтов
Отсутствует
Гипнофобия - боязнь заснуть
Клаустрофобия - боязнь закрытых пространств и помещений
Аматофобия — боязнь пыли
Пирофобия - боязнь огня и пожаров
Гидрофобия (аквафобия) — боязнь воды, сырости, жидкостей
Ангинофобия — боязнь приступа стенокардии
Гамофобия - боязнь вступить в брак
Малевзиофобия (Maleusiophobia) — страх перед родами
Радиофобия — боязнь радиации
Отсутствует
Вакцинофобия — боязнь прививок и связанных с ними неврологических осложнений
Виргинитифобия (Virginitiphobia) — боязнь изнасилования
Айхмофобия — боязнь острых предметов
Тетрафобия - боязнь числа 4
Клаустрофобия - боязнь закрытых пространств и помещений
Мирмекофобия — боязнь муравьёв; частный случай зоофобии
Отсутствует